111111111111111111111111111
133333333333313333333333331
131111311111313111113111131
131111311111313111113111131
133333333333333333333333331
131111313111111111313111131
133333313333313333313333331
111111311111313111113111111
000001310000000000013100000
111111310111111111013111111
000000300190909091003000000
111111310111111111013111111
000001310000000000013100000
111111310111111111013111111
133333333333313333333333331
131111311111313111113111131
133311333000060000333113331
111311313111111111313113111
133333313333313333313333331
131111111111313111111111131
133335333333333333333333331
111111111111111111111111111
