888888888888888888888888888
866666666666686666666666668
868888688888686888886888868
868888688888686888886888868
866666666666666666666666668
868888686888888888686888868
866666686666686666686666668
888888688888686888886888888
000008680000090000086800000
888888680888888888086888888
000000600810203048006000000
888888680888888888086888888
000008680000000000086800000
888888680888888888086888888
866666666666686666666666668
868888688888686888886888868
866688666000050000666886668
888688686888888888686886888
866666686666686666686666668
868888888888686888888888868
866667666666666666666666668
888888888888888888888888888
