111111111111111111111111111
100000000000010000000000001
101111011111010111110111101
101111011111010111110111101
100000000000000000000000001
101111010111111111010111101
100000010000010000010000001
111111011111010111110111111
000001010000000000010100000
111111010111111111010111111
000000000100000001000000000
111111010111111111010111111
000001010000000000010100000
111111010111111111010111111
100000000000010000000000001
101110111111010111111011101
100010000000000000000010001
111010101111111111101010111
100000100000010000001000001
101111111111010111111111101
100000000000000000000000001
111111111111111111111111111
